NooJ v3.x Compiled Dictionary
recognizes 746 word forms.
1517/1 states, 443 different analyses.

Diccionario de determinantes, adverbios, conjunciones, preposiciones y pronombres.
Contiene los verbos ser y haber conjugados.

Códigos:

   Determinantes <DET> (solo artículos y demostrativos por ahora)

+Art: Artículo
+Def: Definido/Determinado
+Indef: Indefinido/Indeterminado

   Adverbios <ADV>

+interrog: Interrogativo
+relat: Relativo
+t: Temporal
+sup: Superlativo
+Apoc: Apocopado
+neg: de Negación
+lug: Lugar
+m: Modo
+c: Cantidad
+afirm: Afirmación
+Duda: Duda
+comp: Comparación

   Conjunciones

CONJC: Copulativa
CONJA: Adversativa
CONJS: Subordinante
CONJD: Distributiva
CONJY: Disyuntiva

   Preposiciones <PREP>

   Pronombres <PRO>

m: Masculino
f: Femenino
n: Neutro
s: Singular
p: Plural
e: Epiceno
N: Nominativo
A: Atono
D: Tónico
a: Acusativo "lo, la"
d: Dativo "le, les"
1: Primera Persona
2: Segunda Persona
3: Tercera Persona
P: Personales

+poses: Posesivo; S: 1 objeto, P: Varios objetos
+dem: Demostrativo
+Num: Numeral
+cuant: Cuantitativo
+indef: Indefinido
+conj: PRO con Conjunción ("con")
+adj: PRO en función adjetiva
+interrog: Interrogativo
+relat: Relativo
+indet: Indeterminado
+ñññ: me, te, se. (Uso interno)